Zadanie 6.1: 
INTERPRETOWANIE->LQWHUSUHWRZDQLH
ROZWESELANIE->URCZHVHODQLH
KONSERWOWANIE->NRQVHUZRZDQLH
WSKAZYWANIE->ZVNDCBZDQLH
DOSKONALENIE->GRVNRQDOHQLH
REKOMPENSOWANIE->UHNRPSHQVRZDQLH
KONSTANTYNOPOLITANECZKA->NRQVWDQWBQRSROLWDQHFCND
ZESZYT->CHVCBW
RADZENIE->UDGCHQLH
DOPILNOWANIE->GRSLOQRZDQLH
PODEJMOWANIE->SRGHMPRZDQLH
AKTYWACJA->DNWBZDFMD
TELEFON->WHOHIRQ
WNIOSKOWANIE->ZQLRVNRZDQLH
ROZDYSPONOWANIE->URCGBVSRQRZDQLH
SPROWADZANIE->VSURZDGCDQLH
SPOWOLNIENIE->VSRZROQLHQLH
KONCENTROWANIE->NRQFHQWURZDQLH
SARENKA->VDUHQND
WSTAWANIE->ZVWDZDQLH
DEMONSTROWANIE->GHPRQVWURZDQLH
REPREZENTOWANIE->UHSUHCHQWRZDQLH
WIROWANIE->ZLURZDQLH
KOMENTOWANIE->NRPHQWRZDQLH
KAPRYSZENIE->NDSUBVCHQLH
DEFINIOWANIE->GHILQLRZDQLH
MONITOR->PRQLWRU
NACHODZENIE->QDFKRGCHQLH
INTERWENIOWANIE->LQWHUZHQLRZDQLH
RATOWANIE->UDWRZDQLH
WZBOGACENIE->ZCERJDFHQLH
SPROSZKOWYWANIE->VSURVCNRZBZDQLH
KOMPUTER->NRPSXWHU
DEGLOMEROWANIE->GHJORPHURZDQLH
MAGISTERIUM->PDJLVWHULXP
DEKOROWANIE->GHNRURZDQLH
WTAJEMNICZENIE->ZWDMHPQLFCHQLH
DEMONTOWANIE->GHPRQWRZDQLH
MAGISTER->PDJLVWHU
CHOINKA->FKRLQND
STUDIOWANIE->VWXGLRZDQLH
DEGRADOWANIE->GHJUDGRZDQLH
PILNOWANIE->SLOQRZDQLH
KONSULTOWANIE->NRQVXOWRZDQLH
SPROSZKOWANIE->VSURVCNRZDQLH
STABLICOWANIE->VWDEOLFRZDQLH
AMATORKA->DPDWRUND
KONFIGUROWANIE->NRQILJXURZDQLH
ADAPTOWANIE->DGDSWRZDQLH
POCHYLANIE->SRFKBODQLH
WSPOMAGANIE->ZVSRPDJDQLH
ABSTRAHOWANIE->DEVWUDKRZDQLH
MULTYPLIKOWANIE->PXOWBSOLNRZDQLH
MUROWANIE->PXURZDQLH
SPROWADZENIE->VSURZDGCHQLH
KUBEK->NXEHN
PAPUGOWANIE->SDSXJRZDQLH
ROZMAWIANIE->URCPDZLDQLH
MATEMATYKA->PDWHPDWBND
BUDYNEK->EXGBQHN
DEOKSYRYBONEUKLOINOWY->GHRNVBUBERQHXNORLQRZB
RYZYKOWANIE->UBCBNRZDQLH
INWENTARYZOWANIE->LQZHQWDUBCRZDQLH
STARTOWANIE->VWDUWRZDQLH
WPISYWANIE->ZSLVBZDQLH
ADRES->DGUHV
PARKOWANIE->SDUNRZDQLH
REFLEKTOWANIE->UHIOHNWRZDQLH
ADMINISTRACJA->DGPLQLVWUDFMD
SAMOLOT->VDPRORW
STWIERDZENIE->VWZLHUGCHQLH
ROZPATRYWANIE->URCSDWUBZDQLH
KANDYDOWANIE->NDQGBGRZDQLH
WIATR->ZLDWU
AFISZOWANIE->DILVCRZDQLH
DEMOKRATYZOWANIE->GHPRNUDWBCRZDQLH
SPOTYKANIE->VSRWBNDQLH
KALIGRAFOWANIE->NDOLJUDIRZDQLH
WODOWANIE->ZRGRZDQLH
MOTOROWA->PRWRURZD
MIGOTANIE->PLJRWDQLH
FIZYKA->ILCBND
KONSTRUOWANIE->NRQVWUXRZDQLH
PLANOWANIE->SODQRZDQLH
REFOWANIE->UHIRZDQLH
WACHLOWANIE->ZDFKORZDQLH
SPRAWDZENIE->VSUDZGCHQLH
WSPOMINANIE->ZVSRPLQDQLH
ABSORBOWANIE->DEVRUERZDQLH
AFIRMOWANIE->DILUPRZDQLH
ASTRONOMIA->DVWURQRPLD
WSPIERANIE->ZVSLHUDQLH
ABDYKOWANIE->DEGBNRZDQLH
RESPEKTOWANIE->UHVSHNWRZDQLH
RABOWANIE->UDERZDQLH
ROZWARSTWIANIE->URCZDUVWZLDQLH
INWOKACJA->LQZRNDFMD
INWESTOWANIE->LQZHVWRZDQLH
ROZSZERZANIE->URCVCHUCDQLH
ARYSTOTELES->DUBVWRWHOHV
